  S ./textures/pillar.xpm
	R 2147483647 600




	NO ./textures/north.xpm
           SO ./textures/south.xpm      
WE ./textures/west.xpm
EA 	./textures/east.xpm


		F	 0,255,255
   C 			  			225,30,0			


111111111111111111111111111111
111111111000200000000000011111
100000000000000000111000100001
110000100000000000000000001111
100001111111000000020000111111
1111111000000000W0000000000001
111100000000001100000002000011
111111111111111111111111111111
110000000000011110000000000011
100000000000111000000000000011
1100000000001110000000000011110
110000000001111000000000000111
111111111111111111111111111111111
