	R 275451 5555555




	NO img/eagle.xpm
           SO img/greystone.xpm      
WE img/purplestone.xpm
EA 	img/redbrick.xpm


		F	 0,255,255
   C 			  			225,30,0			


111111111111111111111111111111
111111111000100000000000011111
100000000000000000111000100001
110000100000000000000000001111
100001111111000000010000111111
1111111000000001W0000000000001
111100000000001100000001000011
111111111111111111111111111111
110000000000011110000000000011
100000000000111000000000000011
110000000000111000000000001111
110000000001111000000000000111
111111111111111111111111111111111
